######################...#################################################################################...############
#~~~~~~~~~~~~~~~~~####..................................########################......................................###
#~~~~~~~~~~~~~~~~~~##.....................................####################......................................#####
#~~~~~~~~~~~~~~~~~~#........................................###############....................................##########
#~~~~~~~~~~~~~~~~~.............##########.....................................................###########################
#~~~~~~~~~~~~~~...........#################.......................................#######################################
#~~~~~~~~~~.................##################.................................###############################~~~~~~~####
#~~~~..........................#################......................................####################~~~~~~~~~~~~~##
#~~.............................####################........................................##########~~~~~~~~~~~~~~~~~~#
#~..................................############..................##########....................###~~~~~~~~~~~~~~~~~~~~~#
#.....................................######....................##############...................~~~~~~~~~~~~~~~~~~~~~~~#
#....................................#########..................##############...................~~~~~~~~~~~~~~~~~~~~~~~#
#........................................##########.............##############....................~~~~~~~~~~~~~~~~~~~~~~#
#...............................................................##############....................~~~~~~~~~~~~~~~~~~~~~~#
...................................................................#######........................~~~~~~~~~~~~~~~~~~~~~~#
.....................................................................###...........................~~~~~~~~~~~~~~~~~~~~~#
.....................................................................##............................~~~~~~~~~~~~~~~~~~~~~#
#....................................................................##...........................########~~~~~~~~~~~~~~#
#....................................................................###...........................############~~~~~#####
#...................................................................######............................###################
#.....................................................................##...............................##################
#.........................................................................................................###############
#.............................................................................................................###########
#..................................................................................................................######
#.....................................................................................................................###
#......................................................................................................................##
#......................................................................................................................##
#...............................................~~~~~~~~~...............................................................#
#............................................~~~~~~~~~~~~~~.............................................................#
#...........................................~~~~#######~~~~~~...........................................................#
#...........................................~~~~#######~~~~~~...........................................................#
#..........................................~~~~~#######~~~~.............................................................#
#..........................................~~~~~#######~~~~~~~..........................................................#
#.........................................~~~~~~#######~~~~~~~..........................................................#
#.........................................~~~~~~~~~~~~~~~~~~............................................................#
#...........................................~~~~~~~~~~~~~...............................................................#
#.......................................................................................................................#
#.......................................................................................................................#
#.......................................................................................................................#
#.......................................................................................................................#
#.......................................................................................................................#
#.......................................................................................................................#
#.......................................................................................................................#
#.......................................................................................................................#
#.......................................................................................................................#
#.......................................................................................................................#
#.......................................................................................................................#
#.......................................................................................................................#
#.......................................................................................................................#
#.......................................................................................................................#
#.......................................................................................................................#
#.......................................................................................................................#
#.......................................................................................................................#
#.......................................................................................................................#
#.......................................................................................................................#
#.......................................................................................................................#
#.......................................................................................................................#
#.......................................................................................................................#
#.......................................................................................................................#
#.......................................................................................................................#
#.......................................................................................................................#
#.......................................................................................................................#
#.......................................................................................................................#
#.......................................................................................................................#
#.......................................................................................................................#
#.......................................................................................................................#
#.......................................................................................................................#
#.......................................................................................................................#
#.......................................................................................................................#
#.......................................................................................................................#
#.......................................................................................................................#
#.......................................................................................................................#
#.......................................................................................................................#
#.......................................................................................................................#
#.......................................................................................................................#
#.......................................................................................................................#
#.......................................................................................................................#
#.......................................................................................................................#
#.......................................................................................................................#
#.......................................................................................................................#
#.......................................................................................................................#
#.......................................................................................................................#
#.......................................................................................................................#
#.......................................................................................................................#
#.......................................................................................................................#
#.......................................................................................................................#
#.......................................................................................................................#
#.......................................................................................................................#
#.......................................................................................................................#
#.......................................................................................................................#
#.......................................................................................................................#
#.......................................................................................................................#
#.......................................................................................................................#
#.......................................................................................................................#
#.......................................................................................................................#
#.......................................................................................................................#
#.......................................................................................................................#
#.......................................................................................................................#
#.......................................................................................................................#
#.......................................................................................................................#
#.......................................................................................................................#
#.......................................................................................................................#
#.......................................................................................................................#
#.......................................................................................................................#
#.......................................................................................................................#
#.......................................................................................................................#
#.......................................................................................................................#
#.......................................................................................................................#
#.......................................................................................................................#
#.......................................................................................................................#
#.......................................................................................................................#
#.......................................................................................................................#
#.......................................................................................................................#
#.......................................................................................................................#
#.......................................................................................................................#
#.......................................................................................................................#
#.......................................................................................................................#
#.......................................................................................................................#
#.......................................................................................................................#
#.......................................................................................................................#
#########################################################################################################################
M
