######################...#################################################################################...############
#~~~~~~~~~~~~~~~~~####..................................########################......................................###
#~~~~~~~~~~~~~~~~~~##.....................................####################......................................#####
#~~~~~~~~~~~~~~~~~~#........................................###############....................................##########
#~~~~~~~~~~~~~~~~~.............##########.....................................................###########################
#~~~~~~~~~~~~~~...........#################.......................................#######################################
#~~~~~~~~~~.................##################.................................###############################~~~~~~~####
#~~~~..........................#################......................................####################~~~~~~~~~~~~~##
#~~.............................####################........................................##########~~~~~~~~~~~~~~~~~~#
#~..................................############..................##########....................###~~~~~~~~~~~~~~~~~~~~~#
#.....................................######....................##############...................~~~~~~~~~~~~~~~~~~~~~~~#
#....................................#########..................##############...................~~~~~~~~~~~~~~~~~~~~~~~#
#........................................##########.............##############.........#..........~~~~~~~~~~~~~~~~~~~~~~#
#...............................................................##############........##..........~~~~~~~~~~~~~~~~~~~~~~#
...................................................................#######...........####.........~~~~~~~~~~~~~~~~~~~~~~#
................................................~~...................###.............#####.........~~~~~~~~~~~~~~~~~~~~~#
......############...........................~~~~~~~.................##..............######........~~~~~~~~~~~~~~~~~~~~~#
##########################.................~~~~~~~~~~~...............##..............#~~~~#.......########~~~~~~~~~~~~~~#
##############################...............~~~~~~~~~~~~~...........###............#~~~~#.........############~~~~~#####
#################################...............~~~~~~~~~~~.........######..........#~~~##............###################
####################################...............~~~~~..............##...........##~~##..............##################
............###########################..............~............................###~~~#.................###############
..............########################...........................................###~~~##..................##############
................................................................................###~~~~~##.....................##########
#####...........................................................................#~~~~~~~~#........................#######
###########.....................................................................~~~~~~~~~~~..........................####
################..............................................................~~~~~~~~~~~~~~..........................###
#############...................................~~~~~~~~~....................~~~~~~~~~~~~~~~~..........................##
##########...................................~~~~~###~~~~~~..................~~~~~~~~~~~~~~~~..........................##
#######..............###....................~~~~#######~~~~~~.................~~~~~~~~~~~~~.............................#
#########..........######...................~~~#########~~~~~...................#~~~~~~~~##..............................
##########........######...................~~~###########~~~.....................############............................
######...........######....................~~~~#########~~~~~~.....................############..........................
####.............~#######.................~~~~~~#######~~~~~~~.......................################...................#
####.............~########................~~~~~~~~###~~~~~~~...........................######################........####
#####............~~########.................~~~~~~~~~~~~~................................##################.........#####
######...........~~########.................................................................#################........####
#####.............~~########...................................................................###############........###
######..............~~########....................................................................##########...........##
#######...............~~##########...................................................................#####..............#
########................~~~##########..................................................................##................
##########.................~~~######~..........................#########................................#................
####~~~~~####...............~~~~~~~~......................#################..............................................
###~~~~~~~~#####..............~~~~~......................#####################..........................................#
##~~~~~~~~~~~####......................................##########################.......................................#
####~~~~~~~~~~~#####...............................##################################...................................#
#######~~~~~~#########........................#############################################.............................#
#######################...##################################################################################...##########
M
